0000000000000
0000000000000
0000000000000
0000000000110
0000000001111
1100001111111
1111111111111
1111111111111